10.ox
....o.....o..o..oo..oo.o..o....o....oo....oo....o.
....o...o..ooo..oo...oo..o.......o.o..............
.....o..oo.o..o.o.o........o.....ooo..........o...
.......oo.o....o.o......oo...o............o.......
.o..ooo...............o.ooo..o............ooo.oo..
.......o.o...o..........o...oo...o.o.......o.....o
........oo.......o.o......................o...o..o
..o....o.o......o....................o..o.......oo
................o.......................o.....o...
..o...o...o....o.o......o..o.o...oo............o..
